10 10
..........
..........
....X.X.X.
.........X
.......X.X
..........
X......X..
..........
..........
..XX.X....
