6 8
X . . . . x
x . . . x .
. . . . . .
. . x . . .
. . . . x .
x . . . x .
. . . . . .
. . . . . x